11111111111111111111111
10000001100010001000001
10110001101010101000001
10110001101010101000001
10110001101010101000001
10110001101010101000001
10110001101010101000001
10110001101010101000001
10110001101010101000001
10110001101010101000001
10110001101010101000001
10110001101010101000001
10110001101010101000001
10110001101010101000001
10000000001000000000001
11111111111111111111111
