11111111111111111111111
10110001100010001000001
10110001101010101000001
10110001101010101000001
10110001101010101000001
10110001101010101000001
10110001101010101000001
10000001100000000000001
10110001101010101000001
10110001101010101000001
10110001101010101000001
10110001101010101000001
10110001101010101000001
10110001101010101000001
10000100001010000000001
11111111111111111111111
