11111111111111111111111
10110001100010001000001
10110001101010101111101
10110001100000000000001
10111011111111111111101
10110001101010101000001
10110001100010101000001
10110001101010101000001
10110001101010101000001
10110001101010101000001
10110001101010101000001
10110001101010101000001
10110001101010101000001
10110001101010101000001
10000000001000000000001
11111111111111111111111
